rows 27
cols 27
m %%%%%%%%%%%%%%%%%%%%%%%%%%%
m %..........%...%..........%
m %..........%...%..........%
m %..........%...%..........%
m %...a.....................%
m %.........................%
m %.........................%
m %.........................%
m %.........................%
m %............%............%
m %............%............%
m %%%%.........%.........%%%%
m %............%............%
m %........%%%%%%%%%........%
m %............%............%
m %%%%.........%.........%%%%
m %............%............%
m %............%............%
m %.........................%
m %.........................%
m %.........................%
m %.........................%
m %.....................b...%
m %..........%...%..........%
m %..........%...%..........%
m %..........%...%..........%
m %%%%%%%%%%%%%%%%%%%%%%%%%%%